데이터기준일자,동별,세대수,인구수(계),인구수(남),인구수(여)
"2025-01-31","부평1동",17196,34809,16671,18138
"2025-01-31","부평2동",7793,15326,7594,7732
"2025-01-31","부평3동",7381,14889,7379,7510
"2025-01-31","부평4동",17750,33475,16530,16945
"2025-01-31","부평5동",16357,33137,16287,16850
"2025-01-31","부평6동",8469,17339,8527,8812
"2025-01-31","산곡1동",6476,14753,7265,7488
"2025-01-31","산곡2동",10680,29107,14264,14843
"2025-01-31","산곡3동",8521,20016,9659,10357
"2025-01-31","산곡4동",6558,16457,7828,8629